8
8
3
E..E....
..E....E
........
........
........
..E...H.
........
........
-------
E..E....
E.......
........
.E.E....
.......E
.E....H.
........
........
-------
E..E....
E.E....E
........
E.....H.
........
..EE...E
........
........
-------


